1815CMSMissionaryRegister	Church Missionary Society; Kerala Missionary Documents
1816CMSMissionaryRegister	CMS Missionary Register; Kerala Missionary Documents
1817CMSMissionaryRegister	CMS Missionary Register; Kerala Missionary Documents
1818CMSMissionaryRegister	CMS Missionary Register; Kerala Missionary Documents
1819CMSMissionaryRegister	CMS Missionary Register; Kerala Missionary Documents
1820CMSMissionaryRegister	CMS Missionary Register; Kerala Missionary Documents
1821CMSMissionaryRegister	CMS Missionary Register; Kerala Missionary Documents
1822CMSMissionaryRegister	CMS Missionary Register; Kerala Missionary Documents
1823CMSMissionaryRegister	CMS Missionary Register; Kerala Missionary Documents
1824CMSMissionaryRegister	CMS Missionary Register; Kerala Missionary Documents
1825CMSMissionaryRegister	CMS Missionary Register; Kerala Missionary Documents
1826CMSMissionaryRegister	CMS Missionary Register; Kerala Missionary Documents
1827CMSMissionaryRegister	CMS Missionary Register; Kerala Missionary Documents
1828CMSMissionaryRegister	CMS Missionary Register; Kerala Missionary Documents
1829CMSMissionaryRegister	CMS Missionary Register; Kerala Missionary Documents
1830CMSMissionaryRegister	CMS Missionary Register; Kerala Missionary Documents
1831CMSMissionaryRegister	CMS Missionary Register; Kerala Missionary Documents
1832CMSMissionaryRegister	CMS Missionary Register; Kerala Missionary Documents
1833CMSMissionaryRegister	CMS Missionary Register; Kerala Missionary Documents
1835CMSMissionaryRegister	CMS Missionary Register; Kerala Missionary Documents
1836CMSMissionaryRegister	CMS Missionary Register; Kerala Missionary Documents
1837CMSMissionaryRegister	CMS Missionary Register; Kerala Missionary Documents
1838CMSMissionaryRegister	CMS Missionary Register; Kerala Missionary Documents
1839CMSMissionaryRegister	CMS Missionary Register; Kerala Missionary Documents
1840CMSMissionaryRegister	CMS Missionary Register; Kerala Missionary Documents
1841CMSMissionaryRegister	CMS Missionary Register; Kerala Missionary Documents
1842CMSMissionaryRegister	CMS Missionary Register; Kerala Missionary Documents
1842ChurchMissionaryGleanerVol2	The Church Missionary Gleaner; Kerala Missionary Documents
1843CMSMissionaryRegister	CMS Missionary Register; Kerala Missionary Documents
1843ChurchMissionaryGleanerVol3	The Church Missionary Gleaner; Kerala Missionary Documents
1844CMSMissionaryRegister	CMS Missionary Register; Kerala Missionary Documents
1845CMSMissionaryRegister	CMS Missionary Register; Kerala Missionary Documents
1846CMSMissionaryRegister	CMS Missionary Register; Kerala Missionary Documents
1846ChurchMissionaryGleanerVol6	The Church Missionary Gleaner; Kerala Missionary Documents
1847CMSMissionaryRegister	CMS Missionary Register; Kerala Missionary Documents
1848CMSMissionaryRegister	CMS Missionary Register; Kerala Missionary Documents
1848ChurchMissionaryGleanerVol8	Church Missionary Gleaner; Kerala Missionary Documents
1849ChurchMissionaryGleanerVol9	Church Missionary Gleaner; Kerala Missionary Documents
1850CMSMissionaryRegister	CMS Missionary Register; Kerala Missionary Documents
1850TheChurchMissionaryIntelligencer	The Church Missionary Intelligencer; Kerala Missionary Documents
1851CMSMissionaryRegister	CMS Missionary Register; Kerala Missionary Documents
1851TheChurchMissionaryGleanerNewSeriesVol1	The Church Missionary Gleaner; Kerala Missionary Documents
1851TheChurchMissionaryIntelligencer	The Church Missionary Intelligencer; Kerala Missionary Documents
1852CMSMissionaryRegister	CMS Missionary Register; Kerala Missionary Documents
1852TheChurchMissionaryGleanerNewSeriesVol2	The Church Missionary Gleaner; Kerala Missionary Documents
1852TheChurchMissionaryIntelligencer	The Church Missionary Intelligencer; Kerala Missionary Documents
1853CMSMissionaryRegister	CMS Missionary Register; Kerala Missionary Documents
1853TheChurchMissionaryGleanerNewSeriesVol3	The Church Missionary Gleaner; Kerala Missionary Documents
1853TheChurchMissionaryIntelligencer	The Church Missionary Intelligencer; Kerala Missionary Documents
1854CMSMissionaryRegister	CMS Missionary Register; Kerala Missionary Documents
1854TheChurchMissionaryGleanerNewSeriesVol4	Church Missionary Gleaner; Kerala Missionary Documents
1854TheChurchMissionaryIntelligencer	The Church Missionary Intelligencer; Kerala Missionary Documents
1855CMSMissionaryRegister	CMS Missionary Register; Kerala Missionary Documents
1855TheChurchMissionaryGleanerNewSeriesVol5	Church Missionary Gleaner; Kerala Missionary Documents
1855TheChurchMissionaryIntelligencer	The Church Missionary Intelligencer; Kerala Missionary Documents
1856TheChurchMissionaryGleanerNewSeriesVol6	The Church Missionary Gleaner; Kerala Missionary Documents
1856TheChurchMissionaryIntelligencer	The Church Missionary Intelligencer; Kerala Missionary Documents
1857TheChurchMissionaryGleanerNewSeriesVol7	The Church Missionary Gleaner; Kerala Missionary Documents
1857TheChurchMissionaryIntelligencer	The Church Missionary Intelligencer; Kerala Missionary Documents
1858TheChurchMissionaryGleanerNewSeriesVol8	The Church Missionary Gleaner; Kerala Missionary Documents
1858TheChurchMissionaryIntelligencer	The Church Missionary Intelligencer; Kerala Missionary Documents
1859TheChurchMissionaryAtlas	The Church Missionary Atlas; Kerala Missionary Documents
1859TheChurchMissionaryGleanerNewSeriesVol9	The Church Missionary Gleaner; Kerala Missionary Documents
1859TheChurchMissionaryIntelligencer	The Church Missionary Intelligencer; Kerala Missionary Documents
1860TheChurchMissionaryGleanerNewSeriesVol10	The Church Missionary Gleaner; Kerala Missionary Documents
1860TheChurchMissionaryIntelligencer	The Church Missionary Intelligencer; Kerala Missionary Documents
1861TheChurchMissionaryGleanerNewSeriesVol11	The Church Missionary Gleaner; Kerala Missionary Documents
1861TheChurchMissionaryIntelligencer	The Church Missionary Intelligencer; Kerala Missionary Documents
1862TheChurchMissionaryGleanerNewSeriesVol12	The Church Missionary Gleaner; Kerala Missionary Documents
1862TheChurchMissionaryIntelligencer	The Church Missionary Intelligencer; Kerala Missionary Documents
1863TheChurchMissionaryGleanerNewSeriesVol13	The Church Missionary Gleaner; Kerala Missionary Documents
1863TheChurchMissionaryIntelligencer	The Church Missionary Intelligencer; Kerala Missionary Documents
1864TheChurchMissionaryGleanerNewSeriesVol14	The Church Missionary Gleaner; Kerala Missionary Documents
1864TheChurchMissionaryIntelligencer	The Church Missionary Intelligencer; Kerala Missionary Documents
1865TheChurchMissionaryGleanerNewSeriesVol15	The Church Missionary Gleaner; Kerala Missionary Documents
1865TheChurchMissionaryIntelligencer	The Church Missionary Intelligencer; Kerala Missionary Documents
1866TheChurchMissionaryGleanerNewSeriesVol16	The Church Missionary Gleaner; Kerala Missionary Documents
1866TheChurchMissionaryIntelligencer	The Church Missionary Intelligencer; Kerala Missionary Documents
1867TheChurchMissionaryGleanerNewSeriesVol17	Church Missionary Gleaner; Kerala Missionary Documents
1868TheChurchMissionaryGleanerNewSeriesVol18	The Church Missionary Gleaner; Kerala Missionary Documents
1868TheChurchMissionaryIntelligencer	The Church Missionary Intelligencer; Kerala Missionary Documents
1869TheChurchMissionaryGleanerNewSeriesVol19	The Church Missionary Gleaner; Kerala Missionary Documents
1869TheChurchMissionaryIntelligencer	The Church Missionary Intelligencer; Kerala Missionary Documents
1870TheChurchMissionaryGleanerNewSeriesVol20	The Church Missionary Gleaner; Kerala Missionary Documents
1870TheChurchMissionaryIntelligencer	The Church Missionary Intelligencer; Kerala Missionary Documents
1871TheChurchMissionaryIntelligencer	The Church Missionary Intelligencer; Kerala Missionary Documents
1873TheChurchMissionaryIntelligencer	The Church Missionary Intelligencer; Kerala Missionary Documents
1874TheChurchMissionaryIntelligencer	The Church Missionary Intelligencer; Kerala Missionary Documents
1875TheChurchMissionaryIntelligencer	The Church Missionary Intelligencer; Kerala Missionary Documents
1876TheChurchMissionaryIntelligencer	The Church Missionary Intelligencer; Kerala Missionary Documents
1877TheChurchMissionaryIntelligencer	The Church Missionary Intelligencer; Kerala Missionary Documents
1878TheChurchMissionaryGleaner	The Church Missionary Gleaner; Kerala Missionary Documents
1878TheChurchMissionaryIntelligencer	The Church Missionary Intelligencer; Kerala Missionary Documents
1879TheChurchMissionaryGleaner	The Church Missionary Gleaner; Kerala Missionary Documents
1879TheChurchMissionaryIntelligencer	The Church Missionary Intelligencer; Kerala Missionary Documents
1880TheChurchMissionaryGleaner	The Church Missionary Gleaner; Kerala Missionary Documents
1880TheChurchMissionaryIntelligencer	The Church Missionary Intelligencer; Kerala Missionary Documents
1881TheChurchMissionaryGleaner	The Church Missionary Gleaner; Kerala Missionary Documents
1881TheChurchMissionaryIntelligencer	The Church Missionary Intelligencer; Kerala Missionary Documents
1882TheChurchMissionaryGleaner	The Church Missionary Gleaner; Kerala Missionary Documents
1882TheChurchMissionaryIntelligencer	The Church Missionary Intelligencer; Kerala Missionary Documents
1883TheChurchMissionaryGleaner	The Church Missionary Gleaner; Kerala Missionary Documents
1883TheChurchMissionaryIntelligencer	The Church Missionary Intelligencer; Kerala Missionary Documents
1884TheChurchMissionaryGleaner	The Church Missionary Gleaner; Kerala Missionary Documents
1884TheChurchMissionaryIntelligencer	The Church Missionary Intelligencer; Kerala Missionary Documents
1885TheChurchMissionaryGleaner	Church Missionary Society; Kerala Missionary Documents
1885TheChurchMissionaryIntelligencer	The Church Missionary Intelligencer; Kerala Missionary Documents
1886TheChurchMissionaryGleaner	The Church Missionary Gleaner; Kerala Missionary Documents
1887TheChurchMissionaryGleaner	The Church Missionary Gleaner; Kerala Missionary Documents
1888TheChurchMissionaryGleaner	The Church Missionary Gleaner; Kerala Missionary Documents
1888TheChurchMissionaryIntelligencer	The Church Missionary Intelligencer; Kerala Missionary Documents
1889TheChurchMissionaryGleaner	The Church Missionary Gleaner; Kerala Missionary Documents
1889TheChurchMissionaryIntelligencer	The Church Missionary Intelligencer; Kerala Missionary Documents
1890TheChurchMissionaryGleaner	The Church Missionary Gleaner; Kerala Missionary Documents
1890TheChurchMissionaryIntelligencer	The Church Missionary Intelligencer; Kerala Missionary Documents
1891TheChurchMissionaryGleaner	The Church Missionary Gleaner; Kerala Missionary Documents
1891TheChurchMissionaryIntelligencer	The Church Missionary Intelligencer; Kerala Missionary Documents
1892TheChurchMissionaryGleaner	The Church Missionary Gleaner; Kerala Missionary Documents
1892TheChurchMissionaryIntelligencer	The Church Missionary Intelligencer; Kerala Missionary Documents
1893TheChurchMissionaryIntelligencer	The Church Missionary Intelligencer; Kerala Missionary Documents
1894TheChurchMissionaryIntelligencer	The Church Missionary Intelligencer; Kerala Missionary Documents
1895TheChurchMissionaryAtlas	The Church Missionary Atlas; Kerala Missionary Documents
1895TheChurchMissionaryIntelligencer	The Church Missionary Intelligencer; Kerala Missionary Documents
1897TheChurchMissionaryIntelligencer	The Church Missionary Intelligencer; Kerala Missionary Documents
1898TheChurchMissionaryGleaner	The Church Missionary Gleaner; Kerala Missionary Documents
1898TheChurchMissionaryIntelligencer	The Church Missionary Intelligencer; Kerala Missionary Documents
1899TheChurchMissionaryIntelligencer	The Church Missionary Intelligencer; Kerala Missionary Documents
1900TheChurchMissionaryGleaner	The Church Missionary Gleaner; Kerala Missionary Documents
1900TheChurchMissionaryIntelligencer	The Church Missionary Intelligencer; Kerala Missionary Documents
1902TheChurchMissionaryGleaner	The Church Missionary Gleaner; Kerala Missionary Documents
1902TheChurchMissionaryIntelligencer	The Church Missionary Intelligencer; Kerala Missionary Documents
1903TheChurchMissionaryGleaner	The Church Missionary Gleaner; Kerala Missionary Documents
1903TheChurchMissionaryIntelligencer	The Church Missionary Intelligencer; Kerala Missionary Documents
1904TheChurchMissionaryIntelligencer	The Church Missionary Intelligencer; Kerala Missionary Documents
