1966octsasthraga0000kssp	ശാസ്ത്രഗതി ലക്കം 1 - 1966 ഒക്ടോബർ - കേരള ശാസ്ത്രസാഹിത്യപരിഷത്ത്	Sasthragathi	Sasthragathi
1969decsasthrake0000kssp	ശാസ്ത്രകേരളം - സയൻസു മാസിക - 1969 ഡിസംബർ	Sasthra Keralam Magazine	Sasthra Keralam Magazine
1969novsasthrake0000kssp	ശാസ്ത്രകേരളം - സയൻസു മാസിക - 1969 നവം‌ബർ	Sasthra Keralam Magazine, KSSP Science Magazine	Sasthra Keralam Magazine; KSSP Science Magazine
1969sathrakerala0000kssp	ശാസ്ത്രകേരളം - സയൻസു മാസിക - 1969 ആഗസ്റ്റ്	Sasthra Keralam Magazine, Malayalam Science Magazine	Sasthra Keralam Magazine; Malayalam Science Magazine
1970augeureka0000kssp	യുറീക്ക - കുട്ടികളുടെ ശാസ്ത്രമാസിക - 1970 ആഗസ്റ്റ് - വാല്യം 1 ലക്കം 3	Eureka Magazine, Malayalam Children's Magazine	Eureka Magazine; Malayalam Children's Magazine
1970deceureka0000kssp	യുറീക്ക - കുട്ടികളുടെ ശാസ്ത്രമാസിക - 1970 ഡിസമ്പർ - വാല്യം 1 ലക്കം 7	Eureka Magazine, Malayalam Children's Magazine	Eureka Magazine; Malayalam Children's Magazine
1970febsasthrake0000kssp	ശാസ്ത്രകേരളം - സയൻസു മാസിക - 1970 ഫെബ്രുവരി	Sasthra Keralam Magazine, KSSP Science Magazine	Sasthra Keralam Magazine; KSSP Science Magazine
1970jansasthrake0000kssp	ശാസ്ത്രകേരളം - സയൻസു മാസിക - 1970 ജനുവരി	Sasthra Keralam Magazine, KSSP Science Magazine	Sasthra Keralam Magazine; KSSP Science Magazine
1970marsasthrake0000kssp	ശാസ്ത്രകേരളം - സയൻസു മാസിക - 1970 മാർച്ച്	Sasthra Keralam Magazine, KSSP Science Magazine	Sasthra Keralam Magazine; KSSP Science Magazine
1970maysasthrake0000kssp	ശാസ്ത്രകേരളം - സയൻസു മാസിക - 1970 മേയ്	Sasthra Keralam Magazin; Malayalam Science Magazine	Sasthra Keralam Magazin; Malayalam Science Magazine
1970noveureka0000kssp	യുറീക്ക - കുട്ടികളുടെ ശാസ്ത്രമാസിക - 1970 നവമ്പർ - വാല്യം 1 ലക്കം 6	Eureka Magazine, Malayalam Children's Magazine	Eureka Magazine; Malayalam Children's Magazine
1970sepeureka0000kssp	യുറീക്ക - കുട്ടികളുടെ ശാസ്ത്രമാസിക - 1970 സെപ്റ്റംബർ - വാല്യം 1 ലക്കം 4	Eureka Magazine, Malayalam Children's Magazine	Eureka Magazine; Malayalam Children's Magazine
1970sepeureka0000kssp_v4f2	യുറീക്ക - കുട്ടികളുടെ ശാസ്ത്രമാസിക - 1970 ഒക്ടോബർ - വാല്യം 1 ലക്കം 5	Eureka Magazine, Malayalam Children's Magazine	Eureka Magazine; Malayalam Children's Magazine
1971apreureka0000kssp	യുറീക്ക - കുട്ടികളുടെ ശാസ്ത്രമാസിക - 1971 ഏപ്രിൽ	Eureka Magazine, Malayalam Children's Magazine	Eureka Magazine; Malayalam Children's Magazine
1971febeureka0000kssp	യുറീക്ക - കുട്ടികളുടെ ശാസ്ത്രമാസിക - 1971 ഫെബ്രുവരി	Eureka Magazine	Eureka Magazine
1971janeureka0000kssp	യുറീക്ക - കുട്ടികളുടെ ശാസ്ത്രമാസിക - 1971 ജനുവരി	Eureka Magazine, Malayalam Children's Magazine	Eureka Magazine; Malayalam Children's Magazine
1971mareureka0000kssp	യുറീക്ക - കുട്ടികളുടെ ശാസ്ത്രമാസിക - 1971 മാർച്ച്	Eureka Magazine, Malayalam Children's Magazine	Eureka Magazine; Malayalam Children's Magazine
1971mayeureka0000kssp	യുറീക്ക - കുട്ടികളുടെ ശാസ്ത്രമാസിക - 1971 മേയ്	Eureka Magazine	Eureka Magazine
1983arogyarekha0000kssp	1983 - ആരോഗ്യരേഖ	KSSP leaflets;KSSP Health Books	KSSP leaflets; KSSP Health Books
1983mannan0000rajm	1983 - മണ്ണൻ - ഡോ: കെ. രാജ്മോഹൻ	KSSP leaflets;KSSP Health Books, Measles	KSSP leaflets; KSSP Health Books; Measles
1983nammudearogy0000ekba	1983 - നമ്മുടെ ആരോഗ്യം - ഡോ: ബി. ഇക്ബാൽ	KSSP leaflets; Kerala Health	KSSP leaflets; Kerala Health
1983pradhamasusr0000jaya	1983 - പ്രഥമശുശ്രൂഷ - ഡോ: എൽ. ജയലക്ഷ്മി	KSSP leaflets; First aid, KSSP Health Books	KSSP leaflets; First aid; KSSP Health Books
1984marunnuvyvas0000ekba	1984 - മരുന്നു വ്യവസായരംഗത്തെ അശാസ്ത്രീയതകൾ - ഡോ. ബി. ഇക്ബാൽ	KSSP leaflets; KSSP Health Books	KSSP leaflets; KSSP Health Books
1984urjamchandra0000kssp	1984 - ഊർജം - സി.വി. ചന്ദ്രൻ	KSSP leaflets;KSSP Books about Power	KSSP leaflets; KSSP Books about Power
1985arationalstu0000jami	1985 - A Rational Study of Analgesics and Antipyretics	KSSP leaflets;KSSP Health Books	KSSP leaflets; KSSP Health Books
1985raionalityst0000shis	Rationality Study of Anti Diarrhoeal Formulations	KSSP leaflets;KSSP Health Books	KSSP leaflets; KSSP Health Books
1986vaidyuthipra0000kssp	1986 - വൈദ്യുതി പ്രതിസന്ധിയും പരിഹാരങ്ങളും	KSSP leaflets;Kerala Energy Problem;KSSP Energy Books	KSSP leaflets; Kerala Energy Problem; KSSP Energy Books
1986vaithyuthipr0000kssp	1986 - വൈദ്യുതി - പ്രതിസന്ധിയും പരിഹാരങ്ങളും - കേരള ശാസ്ത്ര സാഹിത്യ പരിഷത്തിന്റെ നിർദ്ദേശങ്ങൾ	KSSP leaflets;KSSP Energy Books;Power Problex in Kerala	KSSP leaflets; KSSP Energy Books; Power Problex in Kerala
1986vanamvellam0000kssp	1986 - വനം വെള്ളം വൈദ്യുതി	KSSP leaflets;Kerala Energy;KSSP Ecology Books	KSSP leaflets; Kerala Energy; KSSP Ecology Books
1986vyavasayaval0000kssp	1986 - വ്യവസായവല്ക്കരണം (ചോദ്യോത്തരങ്ങൾ) - വന-ഊർജ്ജ-വികസന ജാഥ - 1986 സെപ്റ്റംബർ 1 - 7	KSSP leaflets; KSSP Development Books; Kerala Development	KSSP leaflets; KSSP Development Books; Kerala Development
1986vyavasayaval0000unse	1986 - വ്യവസായവല്ക്കരണം (ചോദ്യോത്തരങ്ങൾ) - വന-ഊർജ്ജ-വികസന ജാഥ - 1986 സെപ്റ്റംബർ 1 - 14	KSSP leaflets; KSSP Development Books; Kerala Development	KSSP leaflets; KSSP Development Books; Kerala Development
1987janakeeyaaro0000kssp	ജനകീയ ആരോഗ്യസർവെ - 1987 - സർവെ പ്രവർത്തകർക്കുള്ള കൈപുസ്തകം	KSSP leaflets;KSSP Health Books;Health Survey	KSSP leaflets; KSSP Health Books; Health Survey
1988vaidyuthikan0000mppa	1988 - കേരളത്തിലെ വൈദ്യുതിപ്രശ്നം കണക്കുകളിലൂടെ - എം.പി. പരമേശ്വരൻ	KSSP leaflets;Kerala Energy Problem;KSSP Energy Books	KSSP leaflets; Kerala Energy Problem; KSSP Energy Books
1988vaidyuthinir0000unse	1988 - കേരളത്തിലെ വൈദ്യുതി പ്രതിസന്ധിയും പരിഹാരമാർഗങ്ങളും - കേരള ശാസ്ത്രസാഹിത്യ പരിഷത്തിന്റെ നിർദ്ദേശങ്ങൾ	KSSP leaflets;Kerala Power Problem	KSSP leaflets; Kerala Power Problem
1989aksharathiln0000kssp	1989 - അക്ഷരത്തിൽ നിന്നു് ആരോഗ്യത്തിലേക്കു്	KSSP leaflets;KSSP Health Books;Kerala Health Problem	KSSP leaflets; KSSP Health Books; Kerala Health Problem
1989arogyasurvey0000kssp	1989 - ആരോഗ്യ സർവെ - പ്രാഥമിക പാഠങ്ങൾ	KSSP leaflets;KSSP Health Books;Health Survey	KSSP leaflets; KSSP Health Books; Health Survey
1989deseeyavanit0000kssp	1989 - ദേശീയ വനിതാവികസന പരിപ്രേക്ഷ്യം: ഒരു വിമർശനം	KSSP leaflets;KSSP Gender Books	KSSP leaflets; KSSP Gender Books
1989parishathums0000kssp	1989 - പരിഷത്തും സ്ത്രീപ്രശ്നവും	KSSP leaflets about Gender	KSSP leaflets about Gender
1989parishathums0000kssp_z0l1	1989 - പരിഷത്തും സ്ത്രീപ്രശ്നവും	KSSP leaflets;KSSP Gender Books	KSSP leaflets; KSSP Gender Books
1989randayiraman0000kssp	2000ാമാണ്ടോടെ എല്ലാവർക്കും ആരോഗ്യം - സങ്കൽപ്പവും യാഥാർത്ഥ്യവും	KSSP leaflets;KSSP Health Books	KSSP leaflets; KSSP Health Books
1989rogaprathiro0000kssp	1989 - രോഗ പ്രതിരോധ സർവെ റിപ്പോർട്ട് - വയനാട് ജില്ല	KSSP leaflets;KSSP Health Books;Health Survey	KSSP leaflets; KSSP Health Books; Health Survey
1989sthreekalude0000kssp	1989 - സ്ത്രീകളുടെ പ്രശ്നങ്ങൾ	KSSP leaflets; KSSP Books about Gender Bias	KSSP leaflets; KSSP Books about Gender Bias
1989sthreekalums0000kssp	1993 - സ്ത്രീകളും സാമൂഹ്യമാറ്റവും	KSSP leaflets;KSSP Gender Books	KSSP leaflets; KSSP Gender Books
1989sthreekalums0000kssp_d4r6	1989 - സ്ത്രീകളും സാമൂഹ്യമാറ്റവും	KSSP leaflets;KSSP Gender Books	KSSP leaflets; KSSP Gender Books
1990jalajanyarog0000kssp	1990 - ജലജന്യ രോഗങ്ങൾ	KSSP leaflets;KSSP Health Books	KSSP leaflets; KSSP Health Books
1990keratintevai0000kssp	1990 - കേരളത്തിന്റെ വൈദ്യുതി പ്രതിസന്ധി - കേരള ശാസ്ത്രസാഹിത്യ പരിഷത്തിന്റെ നിലപാട്	KSSP leaflets;Kerala Energy Problem;KSSP Energy Books	KSSP leaflets; Kerala Energy Problem; KSSP Energy Books
1990vanithakalum0000kssp	1990 - വനിതകളും സാക്ഷരതയും	KSSP leaflets;KSSP Gender Books	KSSP leaflets; KSSP Gender Books
1990vanithangalu0000kssp	1990 - വനിതകളും വ്യക്തിനിയമങ്ങളും	KSSP leaflets;KSSP Gender Books;Civil Code and Gender Bias	KSSP leaflets; KSSP Gender Books; Civil Code and Gender Bias
1992healthpolicy0000kssp	1992 - Health Policy for Kerala - Draft	KSSP leaflets;KSSP Health Books	KSSP leaflets; KSSP Health Books
1992kerathinuoru0000kssp	1992 - കേരളത്തിന് ഒരു ആരോഗ്യനയം - കരടുരേഖ	KSSP leaflets;KSSP Health Books	KSSP leaflets; KSSP Health Books
1992marunnukalud0000kssp	1992 - മരുന്നുകളുടെ വിലവർധനവും പുതിയ സാമ്പത്തിക നയങ്ങളും	KSSP leaflets;KSSP Health Books;Medicine Price Hike	KSSP leaflets; KSSP Health Books; Medicine Price Hike
1993samuhyasamra0000kssp	1993 - സാമൂഹ്യസംരക്ഷണ നിയമങ്ങളും സ്ത്രീകളും	KSSP leaflets;KSSP Gender Books;Gender Bias	KSSP leaflets; KSSP Gender Books; Gender Bias

1993sthreekalude0000para	1993 - സ്ത്രീകളുടെ ആരോഗ്യപ്രശ്നങ്ങൾ - ഡോ: സി.എൻ. പരമേശ്വരൻ	KSSP leaflets; Women's Health; KSSP Books about Health; KSSP books about women	KSSP leaflets; Women's Health; KSSP Books about Health; KSSP books about women
1993vanithasasth0000kssp	1993 - വനിതാ ശാസ്ത്രസംഗമം - കൈപുസ്തകം	KSSP leaflets;KSSP Gender Books;Gender Bias in Kerala	KSSP leaflets; KSSP Gender Books; Gender Bias in Kerala
1994elippaniyump0000kssp	1994 - എലിപ്പനിയും പ്ലേഗും	KSSP leaflets;KSSP Health Books;Leptospirosis;Plague	KSSP leaflets; KSSP Health Books; Leptospirosis; Plague
1994urjarekha0000unse	1994 - ഊർജ്ജരേഖ	KSSP leaflets;Power Problem of Kerala, KSSP Books about Power	KSSP leaflets; Power Problem of Kerala; KSSP Books about Power
1995arogyarangat0000kssp	1995 - ആരോഗ്യരംഗത്തെ പ്രശ്നങ്ങൾ	KSSP leaflets;KSSP Health Books	KSSP leaflets; KSSP Health Books
1995bhashasamska0000kssp	1995 - ജനകീയ വിദ്യാഭ്യാസ നിഷേധം കേരളത്തിൽ	KSSP leaflets;Kerala Public Education;KSSP Education Books	KSSP leaflets; Kerala Public Education; KSSP Education Books
1995bodhanamadhy0000kssp	1995 - ബോധന മാധ്യമം മാതൃഭാഷയിൽ	KSSP leaflets;Kerala Public Education;KSSP Education Books; Vidyabhyasa Jadha-95	KSSP leaflets; Kerala Public Education; KSSP Education Books; Vidyabhyasa Jadha-95
1995janakeeyvidy0000kssp	1995 - ജനകീയ വിദ്യാഭ്യാസ നിഷേധം കേരളത്തിൽ	KSSP leaflets;Kerala Public Education;KSSP Education Books;Vidyabhyasa Jadha-95	KSSP leaflets; Kerala Public Education; KSSP Education Books; Vidyabhyasa Jadha-95
1995keralavidyab0000kssp	1995 - കേരള വിദ്യാഭ്യാസരംഗം വഴിത്തിരിവിൽ	KSSP leaflets;Kerala Public Education, Vidyabhyasa Jadha-95	KSSP leaflets; Kerala Public Education; Vidyabhyasa Jadha-95
1995parishathuma0000kssp	1995 - പരിഷത്തും അക്കാദമിക രംഗത്തെ സമരവും	KSSP leaflets;Kerala Public Education;KSSP Education Books;KSSP and Education Debates	KSSP leaflets; Kerala Public Education; KSSP Education Books; KSSP and Education Debates
1995swashrayavid0000kssp	1995 - സ്വാശ്രയവിദ്യാഭ്യാസവും സാമൂഹിക നീതിയും	KSSP leaflets; Kerala Education; KSSP Books about Education; Vidyabhyasa Jadha-95	KSSP leaflets; Kerala Education; KSSP Books about Education; Vidyabhyasa Jadha-95
1995urjavivadamkssp	1995 - ഊർജവിവാദം പതിറ്റാണ്ടുകളിലൂടെ - ഒരു ചുമർപുസ്തകം	['Kerala Electricity', 'KSSP leaflets', 'Kerala Energy']	Kerala Electricity; KSSP leaflets; Kerala Energy
adhikaramjanangalkkufirstedn1989kssp	അധികാരം ജനങ്ങൾക്ക് - ഒന്നാം പതിപ്പ് - കേരള ശാസ്ത്രസാഹിത്യ പരിഷത്ത്	['Planning, evelopment', 'Kerala Archives']	Planning; evelopment; Kerala Archives
adhikaramjanangalkkusecondedn1989kssp	അധികാരം ജനങ്ങൾക്ക് - രണ്ടാം പതിപ്പ് - കേരള ശാസ്ത്രസാഹിത്യ പരിഷത്ത്	['Decentralization, Planning, Democracy', 'Kerala Archives']	Decentralization; Planning; Democracy; Kerala Archives
aksharajathaganangal1989kssp	അക്ഷരജാഥ - ഗാനങ്ങൾ സംഗീത ശില്പങ്ങൾ - കേരള ശാസ്ത്രസാഹിത്യ പരിഷത്ത്	Kala Jatha, Street Theatre	Kala Jatha; Street Theatre
aksharakalajatha1989kssp	അക്ഷര കലാജാഥ 89 - എറണാകുളം ജില്ല സമ്പൂർണ്ണ സാക്ഷരതായജ്ഞം	['Ernakulam District Total Literarcy Programme', 'Kerala Literacy']	Ernakulam District Total Literarcy Programme; Kerala Literacy
aksharam1989kssp	അക്ഷരം - അധ്യാപനസഹായി - എറണാകുളം ജില്ല സമ്പൂർണ്ണ സാക്ഷരതായജ്ഞം	Ernakulam District Total Literarcy Programme	Ernakulam District Total Literarcy Programme
aksharam1989mhrdgoi	അക്ഷരം - സാക്ഷരതാ പാഠാവലി - എറണാകുളം ജില്ല സമ്പൂർണ്ണ സാക്ഷരതായജ്ഞം	['Ernakulam District Total Literarcy Programme', 'Kerala Literacy']	Ernakulam District Total Literarcy Programme; Kerala Literacy
alamarayileswapnangal0000kssp	അലമാരയിലെ സ്വപ്നങ്ങൾ - നാടകങ്ങൾ - കിളിക്കൂട്ടം ജാഥാ സ്ക്രിപ്റ്റ് - കേരള ശാസ്ത്രസാഹിത്യ പരിഷത്ത്	Kilikkkoottam Jadha, Street Theatre	Kilikkkoottam Jadha; Street Theatre
ammaparayunnu1992kssp	അമ്മ പറയുന്നു - നവോത്ഥാന ജാഥാസ്ക്രിപ്റ്റുകൾ - കേരള ശാസ്ത്രസാഹിത്യ പരിഷത്ത്	Street Theatre	Street Theatre
asthama0000kssp	ആസ്‌ത്‌മ - ഗ്രാമശാസ്ത്രജാഥ - കേരള ശാസ്ത്രസാഹിത്യ പരിഷത്ത്	Health Education, Asthma	Health Education; Asthma
aushadhavilavard0000ekba	ഔഷധ വിലവർധന എന്തുകൊണ്ട്? - ഡോ: ബി. ഇക്ബാൽ	KSSP leaflets;KSSP Health Books	KSSP leaflets; KSSP Health Books
ayesteeyes1989kssp	ഏയെസ് ടീയെസ് - കേരള ശാസ്ത്രസാഹിത്യ പരിഷത്ത്	Kala Jatha, Street Theatre	Kala Jatha; Street Theatre
badalbudjet1993kssp	ബജറ്റും ബദൽ ബജറ്റും  – കേരള സ്വാശ്രയ സമിതി	['Economics, Badjet', 'Kerala Swashraya Samithy']	Economics; Badjet; Kerala Swashraya Samithy
balavedidinam1991kssp	ബാലവേദി ദിനം 1991 - കേരള ശാസ്ത്രസാഹിത്യ പരിഷത്ത്	Balavedi, Science History	Balavedi; Science History
balikalathilekku1985kssp	ബലിക്കളത്തിലേക്ക് - ഗാനങ്ങൾ നാടകങ്ങൾ സംഗീതശില്പങ്ങൾ - ശാസ്ത്രകലാജാഥ 1985 - കേരള ശാസ്ത്രസാഹിത്യ പരിഷത്ത്	Sasthra Kala Jatha, Street Theatre	Sasthra Kala Jatha; Street Theatre
balolasavajatha1986kssp	ചങ്ങലക്കണ്ണി - ബാലോത്സവജാഥ സ്ക്രിപ്റ്റുകൾ - കേരള ശാസ്ത്രസാഹിത്യ പരിഷത്ത്	Balalsava Jatha, Street Theatre	Balalsava Jatha; Street Theatre
balolsavam1987kssp	ബാലോത്സവപ്പാട്ടുകൾ - കേരള ശാസ്ത്രസാഹിത്യ പരിഷത്ത്	Balolsava Songs	Balolsava Songs
bruno1985kssp	ബ്രൂണോ - നാടകങ്ങൾ - ശാസ്ത്രകലാജാഥ 1985 - കേരള ശാസ്ത്രസാഹിത്യ പരിഷത്ത്	Sasthra Kala Jatha, Street Theatre	Sasthra Kala Jatha; Street Theatre
cheruthumvaluthum1984kssp	ചെറുതിൽ ചെറുതും വലുതിൽ വലുതും - പി.ആർ. മാധവപ്പണിക്കർ - കേരള ശാസ്ത്രസാഹിത്യ പരിഷത്ത്	kssp-science books, P R Madhavappanikkar, Malayalam Physics Books	kssp-science books; P R Madhavappanikkar; Malayalam Physics Books
chithrangalktrvarma1979kssp	1979 - ചിത്രങ്ങളുടെ കഥ - കെ.ടി. രാമവർമ്മ	Painting, Art, History	Painting; Art; History
cvraman1982kssp	സി.വി. രാമൻ - ശാസ്ത്രപാഠാവലി - കേരള ശാസ്ത്രസാഹിത്യ പരിഷത്ത്	Science Education, Biography, C V Raman	Science Education; Biography; C V Raman
denkelnirdhesam1992kssp	ഡങ്കെൽ നിർദ്ദേശങ്ങൾ - കോളനിവൽക്കരണത്തിന്റെ പുതിയ മാർഗം - കേരള ശാസ്ത്രസാഹിത്യ പരിഷത്ത്	['Dunkal Draft', 'Kerala Archives']	Dunkal Draft; Kerala Archives
deshabhimana1993kssp	ദേശാഭിമാനപരമായ ബദൽ പരിപാടി – കേരള സ്വാശ്രയ സമിതി	['New Economic Policy of India, Kerala Swasraya Samithi', 'Kerala Sasthra Sahithya Parishad']	New Economic Policy of India; Kerala Swasraya Samithi; Kerala Sasthra Sahithya Parishad
dhooredhooredhoore1990prmadhavapanicker	ദൂരെ ദൂരെ ദൂരെ -  പി.ആർ. മാധവപ്പണിക്കർ - കേരള ശാസ്ത്രസാഹിത്യ പരിഷത്ത്	['kssp-science books', 'P R Madhavappanikkar', 'Malayalam Physics Books']	kssp-science books; P R Madhavappanikkar; Malayalam Physics Books
ekmdistliteracy1990kssp	Ernakulam District Total Literarcy Project - A Report - Kerala Sastra Sahithya Parishad	['Ernakulam District Total Literarcy Programme', 'Kerala Literacy']	Ernakulam District Total Literarcy Programme; Kerala Literacy
eurekakalikal1992kssp	യുറീക്കാ ശാസ്ത്രക്കളികൾ - കേരള ശാസ്ത്രസാഹിത്യ പരിഷത്ത്	Science Education	Science Education
eurekamagazinevo0000kssp	യുറീക്ക - കുട്ടികളുടെ ശാസ്ത്രമാസിക - 1970 ജൂൺ - വാല്യം 1 ലക്കം 1	Eureka Magazine, Malayalam Children's Magazine	Eureka Magazine; Malayalam Children's Magazine
eurekamagazinevo0000kssp_b8f9	യുറീക്ക - കുട്ടികളുടെ ശാസ്ത്രമാസിക - 1970 ജൂലായ് - വാല്യം 1 ലക്കം 2	Eureka Magazine	Eureka Magazine
expresshway2004kssp	എക്സ്പ്രസ്സ് ഹൈവേ - ജലനിധി - ചെറുത്തു തോൽപ്പിക്കേണ്ട രണ്ട് വികസന വിരുദ്ധ പദ്ധതികൾ	Kerala Development, Express Highway, Jalanidhi	Kerala Development; Express Highway; Jalanidhi
ezhuthupusthakam1989kssp	അക്ഷരം - എഴുത്തുപുസ്തകം - എറണാകുളം ജില്ല സമ്പൂർണ്ണ സാക്ഷരതായജ്ഞം	['Ernakulam District Total Literarcy Programme', 'Kerala Literacy']	Ernakulam District Total Literarcy Programme; Kerala Literacy
ganithamekmlit1989kssp	ഗണിതം - അധ്യാപനസഹായി - എറണാകുളം ജില്ല സമ്പൂർണ്ണ സാക്ഷരതായജ്ഞം	['Ernakulam District Total Literarcy Programme; Mathematics Hand Book', 'Kerala Literacy']	Ernakulam District Total Literarcy Programme; Mathematics Hand Book; Kerala Literacy
gattumnayangalum1994kssp	ഗാട്ടും പുത്തൻ സാമ്പത്തിക നയങ്ങളും - കുറെ ചോദ്യങ്ങളും ഉത്തരങ്ങളും – കേരള സ്വാശ്രയ സമിതി	['Globalization, Gatt Agreement', 'Kerala Swashraya Samithy']	Globalization; Gatt Agreement; Kerala Swashraya Samithy
geethangal1980kssp	ഗീതങ്ങൾ - ശാസ്ത്രകലാജാഥ - കേരള ശാസ്ത്രസാഹിത്യ പരിഷത്ത്	['Sasthra Kala Jatha', 'Kerala Archives']	Sasthra Kala Jatha; Kerala Archives
gramavikasanarekha1984kssp	1984 - ഗ്രാമവികസനം - കേരള ശാസ്ത്രസാഹിത്യ പരിഷത്ത്	Kerala Economy, Rural Development	Kerala Economy; Rural Development
hallydhumakethu1986kssp	ഹാലി ധൂമകേതുവിനു സ്വാഗതം - നക്ഷത്രക്കുറിപ്പുകൾ - കേരള ശാസ്ത്രസാഹിത്യ പരിഷത്ത്	Astronomy, Halley's comet	Astronomy; Halley's comet

indiayerakshikkan1992kssp	ഇന്ത്യയെ രക്ഷിക്കാൻ – കേരള സ്വാശ്രയ സമിതി	['Globalization, Dunkal Draft, Indian Economy', 'Kerala Swashraya Samithy']	Globalization; Dunkal Draft; Indian Economy; Kerala Swashraya Samithy
irupathonnamnutandu1986kssp	ഇരുപത്തൊന്നാം നൂറ്റാണ്ടിലേക്ക് - ഗാനങ്ങളും സംഗീതശില്പങ്ങളും നാടകങ്ങളും - ശാസ്ത്രസാംസ്കാരികജാഥ 1986 - കേരള ശാസ്ത്രസാഹിത്യ പരിഷത്ത്	Sasthra Kala Jatha, Street Theatre	Sasthra Kala Jatha; Street Theatre
isrocharacase1995kssp	ഇന്ത്യൻ ബഹിരാകാശ ഗവേഷണം ചാരവൃത്തിക്കു മുമ്പും പിമ്പും - കേരള ശാസ്ത്രസാഹിത്യ പരിഷത്ത്	['ISRO; KSSP leaflets', 'Kerala Archives']	ISRO; KSSP leaflets; Kerala Archives
janakeeyasasthraprasthanam1992kssp	ജനകീയ ശാസ്ത്രപ്രസ്ഥാനം വിശാലമാക്കുന്ന പ്രവർത്തന മേഖലകൾ - കേരള ശാസ്ത്രസാഹിത്യ പരിഷത്ത്	People's Science Movement in Kerala	People's Science Movement in Kerala
janakeeyasuthranavivadam2003kssp	ജനകീയാസൂത്രണ വിവാദം - ശാസ്ത്രസാഹിത്യ പരിഷത്തിന് പറയാനുള്ളത്	People's Planning	People's Planning
janakiyasuthranam2002kssp	ജനകീയാസൂത്രണം - അനുഭവങ്ങളും അടിയന്തര കടമകളും - കേരള ശാസ്ത്രസാഹിത്യ പരിഷത്ത്	People's Planning; Participative Democracy, Decentralization	People's Planning; Participative Democracy; Decentralization
janangal1989kssp	ജനങ്ങൾ സാക്ഷരരാകുന്നതെന്തിന് - സി.ജി. ശാന്തകുമാർ	['Education, Literacy', 'Kerala Literacy']	Education; Literacy; Kerala Literacy
jwala0000kssp	ജ്വാല - ശാസ്ത്രഗീതങ്ങൾ - കേരള ശാസ്ത്രസാഹിത്യ പരിഷത്ത്	Bhopal Gas Tragedy	Bhopal Gas Tragedy
kalarppuvasthukkal0000kssp	കലർപ്പുവസ്തുക്കളും കണ്ടുപിടിക്കുന്നതിനുള്ള മാർഗ്ഗങ്ങളും - ഗ്രാമശാസ്ത്രജാഥ - കേരള ശാസ്ത്രസാഹിത്യ പരിഷത്ത്	Science Education, Adulteration	Science Education; Adulteration
kalikkamaravindgupta1990kssp	കളിക്കാം പഠിക്കാം - അരവിന്ദ് ഗുപ്ത	Malayalam Science Education Books	Malayalam Science Education Books
'subject'
kalikoottam1992kssp	കളിക്കൂട്ടം - കുട്ടികളുടെ ഒഴിവുകാല പരിപാടി - പ്രവർത്തകർക്കുള്ള കുറിപ്പുകൾ	False	
kalivela2002kssp	2002 - കളിവേള - ബാലവേദി കൈപുസ്തകം - കേരള ശാസ്ത്രസാഹിത്യ പരിഷത്ത്	['KSSP leaflets', 'Kerala Archives']	KSSP leaflets; Kerala Archives
kallukalkrama1979kssp	കല്ലുകൾ കഥ പറയുന്നു - കെ. രാമചന്ദ്രൻ	['Parishath Geology Books, Rock', 'KSSP Books']	Parishath Geology Books; Rock; KSSP Books
kannethathaprmad1983kssp	കണ്ണെത്താത്ത ദൂരങ്ങളിൽ - പി.ആർ. മാധവപണിക്കർ	Astronomy, Cosmology	Astronomy; Cosmology
kanyabhoomi1990kssp	കന്യാഭൂമി - സംഗീത ശിൽപങ്ങളും നാടകങ്ങളും - ഭാരത വിജ്ഞാൻ സമിതി	['Bharat Gyanvigyan Samithi Kerala, Street Theatre in Kerala, Literacy, Gender', 'Kerala Sasthra Sahithya Parishad', 'Kerala Archives']	Bharat Gyanvigyan Samithi Kerala; Street Theatre in Kerala; Literacy; Gender; Kerala Sasthra Sahithya Parishad; Kerala Archives
kariyunnakalpavriksham1984kssp	കരിയുന്ന കല്പവൃക്ഷം - എം.പി. പരമേശ്വരൻ, ടി.എം. തോമസ് ഐസക്ക്	Kerala Coconut Industry; KSSP leaflets	Kerala Coconut Industry; KSSP leaflets
karshikameghala1993kssp	പുത്തൻ സാമ്പത്തിക പരിഷ്കാരങ്ങളും കാർഷിക മേഖലയും - കേരള സ്വാശ്രയ സമിതി	['Dunkal Draft, New Economic Policy, Agriculture', 'Kerala Swashraya Samithy']	Dunkal Draft; New Economic Policy; Agriculture; Kerala Swashraya Samithy
kavimalika1986kssp	കവിമാലിക - സംഗീതശില്പം - ശാസ്ത്രസാംസ്കാരികജാഥ 1986 - കേരള ശാസ്ത്രസാഹിത്യ പരിഷത്ത്	Kala Jatha, Street Theatre	Kala Jatha; Street Theatre
kayalnammude1991kssp	കായൽ നമ്മുടെ സമ്പത്ത് - കായൽ സംരക്ഷണ ജാഥ - കേരള ശാസ്ത്രസാഹിത്യ പരിഷത്ത്	Kala Jatha, Ecology	Kala Jatha; Ecology
keralapanchayathraj1995kssp	കേരള പഞ്ചായത്ത് രാജ് നിയം 1994 - ഒരു വിലയിരുത്തൽ	Kerala Panchayathraj	Kerala Panchayathraj
keralathilevidyabhyasam1994kssp	കേരളത്തിലെ വിദ്യാഭ്യാസം - പ്രശ്നങ്ങളും കടമകളും - കേരള ശാസ്ത്രസാഹിത്യ പരിഷത്ത്	Education	Education
keralathintesampathu1984edn6kssp	1984 - കേരളത്തിന്റെ സമ്പത്തു് - ആറാം പതിപ്പ് - കേരള ശാസ്ത്രസാഹിത്യ പരിഷത്ത്	KSSP General Documents	KSSP General Documents
keralathinuoruar0000kssp	കേരളത്തിന് ഒരു ആരോഗ്യനയം - ചർച്ചക്കുള്ള കുറിപ്പുകൾ	KSSP leaflets;KSSP Health Books;Kerala Health Books	KSSP leaflets; KSSP Health Books; Kerala Health Books
keralavikasanam0000kssp	കേരളം ഒരു വികസന പരിപ്രേക്ഷ്യം - കേരള ശാസ്ത്രസാഹിത്യ പരിഷത്ത്	['Development, Decentralization', 'Kerala Archives']	Development; Decentralization; Kerala Archives
keramulamkadukal0000kssp	കേരളത്തിലെ മുളങ്കാടുകൾ - ഒരു ശാസ്ത്രീയ സമീപനത്തിന്റെ ആവശ്യകത	['Bamboo', 'Kerala Environment']	Bamboo; Kerala Environment
kilikoottam0000kssp	കിളിക്കൂട്ടം - ഗാനങ്ങൾ, നാടകങ്ങൾ - ജാഥാ സ്ക്രിപ്റ്റ് - കേരള ശാസ്ത്രസാഹിത്യ പരിഷത്ത്	Kala Jatha, Street Theatre	Kala Jatha; Street Theatre
'subject'
kssp-archives	Kerala Sasthra Sahithya Parishad	False	
kssp-inaguration1962kssp	1962 - കേരള ശാസ്ത്രസാഹിത്യപരിഷത്ത് രൂപീകരണ പത്രവാർത്തകൾ	news kssp-inaguration	news kssp-inaguration
ksspsilentvalley0000kssp	1979 - സൈലന്റ്‌വാലി പദ്ധതി - ഒരു സാങ്കേതിക- പാരിസ്ഥിതിക-സാമൂഹ്യ-രാഷ്ട്രീയ പഠനം	KSSP leaflets; Silent Valley	KSSP leaflets; Silent Valley
ksspsouvenir1983kssp	1983 - കേരള ശാസ്ത്ര സാഹിത്യ പരിഷത്ത് 20-ാം വാർഷികം - സുവനീർ	KSSP Souvenir	KSSP Souvenir
ksspurjapathisan0000kssp	1992 - കേരളത്തിന്റെ ഊർജപ്രതിസന്ധിയും കായം‌കുളം താപനിലയവും	KSSP leaflets, Power Problem in Kerala, Kayamkulam Thermal Station KSSP Books about Energy	KSSP leaflets; Power Problem in Kerala; Kayamkulam Thermal Station KSSP Books about Energy
kushtaraogam0000kssp	കുഷ്ഠരോഗത്തെ മനസ്സിലാക്കുക - ഗ്രാമശാസ്ത്രജാഥ - കേരള ശാസ്ത്രസാഹിത്യ പരിഷത്ത്	Health, leprosy	Health; leprosy
leadkindlylight1989kssp	Lead Kindly Light - Ernakulam District Literacy Programme	['Ernakulam District Total Literarcy Programme', 'Kerala Literacy']	Ernakulam District Total Literarcy Programme; Kerala Literacy
mahothsavam1997kssp	മഹോത്സവം - സമത കലാജാഥ 1997 സ്ക്രിപ്റ്റുകൾ - കേരള ശാസ്ത്രസാഹിത്യ പരിഷത്ത്	Kala Jatha, Street Theatre	Kala Jatha; Street Theatre
mamsamthinnunnasasyangal0000kssp	മാംസം തിന്നുന്ന സസ്യങ്ങൾ - കേരള ശാസ്ത്രസാഹിത്യ പരിഷത്ത്	carnivorous plants	carnivorous plants
manushyankatha1989ekmlit	മനുഷ്യൻ മനുഷ്യനായ കഥ - അധ്യാപനസഹായി - എറണാകുളം ജില്ല സമ്പൂർണ്ണ സാക്ഷരതായജ്ഞം	['History', 'Ernakulam District Total Literarcy Programme']	History; Ernakulam District Total Literarcy Programme
maramparanja0000kssp	ഒരു മരം പറഞ്ഞ കഥ - ഗ്രാമശാസ്ത്രജാഥ - കേരള ശാസ്ത്രസാഹിത്യ പരിഷത്ത്	Environment	Environment
marichavareadakal1984kssp	മരിച്ചവരെ അടക്കൽ - നാടകങ്ങൾ - കേരള ശാസ്ത്രസാഹിത്യ പരിഷത്ത്	Kala Jatha, Street Theatre	Kala Jatha; Street Theatre
medicalsamaram0000ekba	മെഡിക്കൽ സമരം ഉയർത്തിയ പ്രശ്നങ്ങൾ - ഡോ: ബി. ഇക്ബാൽ	KSSP leaflets;KSSP Health Books	KSSP leaflets; KSSP Health Books
mochanam1982kssp	മോചനം -  ശാസ്ത്രകലാജാഥ - കേരള ശാസ്ത്രസാഹിത്യ പരിഷത്ത്	Sasthra Kala Jatha, Street Theatre	Sasthra Kala Jatha; Street Theatre
mollakkayudekuthira1987kssp	മൊല്ലാക്കയുടെ കുതിര - പാവനാടകങ്ങൾ - ബാലോത്സവജാഥ 1987 - കേരള ശാസ്ത്രസാഹിത്യ പരിഷത്ത്	Sasthra Kala Jatha, Street Theatre	Sasthra Kala Jatha; Street Theatre
nadakangal1981kssp	വെളിച്ചത്തിലേക്ക്, ആഫീസ് (നാടകങ്ങൾ) - ശാസ്ത്രകലാജാഥ - കേരള ശാസ്ത്രസാഹിത്യ പരിഷത്ത്	['Sasthra Kala Jatha, Street Theatre', 'Kerala Archives']	Sasthra Kala Jatha; Street Theatre; Kerala Archives
nadakasilpasala0000kssp	ബഹുജന നാടക പ്രസ്ഥാനം ശിൽപ്പശാല - കുറിപ്പുകൾ - കേരള ശാസ്ത്രസാഹിത്യ പരിഷത്ത്	Street Theatre	Street Theatre
naleyudempp1983kssp	നാളെയുടെ വാഗ്ദാനം - എം.പി. പരമേശ്വരൻ	['politics', 'KSSP Books']	politics; KSSP Books
nallanaale1989ekmlit	നല്ലനാളെ - അധ്യാപനസഹായി - എറണാകുളം ജില്ല സമ്പൂർണ്ണ സാക്ഷരതായജ്ഞം	['KSSP- Health Education Books; Ernakulam District Total Literarcy Programme', 'Ernakulam District Total Literarcy Programme']	KSSP- Health Education Books; Ernakulam District Total Literarcy Programme; Ernakulam District Total Literarcy Programme
nammalariyan2000kssp	നമ്മളറിയാൻ - ആഗോളവൽക്കരണത്തിനെതിരെ ജനജാഗ്രത	Globalization	Globalization
nammalonnu1986kssp	നമ്മളൊന്ന് - ഗാനങ്ങളും സംഗീതശില്പങ്ങളും - ശാസ്ത്രകലാജാഥ 1986 - കേരള ശാസ്ത്രസാഹിത്യ പരിഷത്ത്	Kala Jatha, Street Theatre	Kala Jatha; Street Theatre
namukkuchuttumullalokam1989kssp	നമുക്കു ചുറ്റുമുള്ള ലോകം - അധ്യാപനസഹായി - എറണാകുളം ജില്ല സമ്പൂർണ്ണ സാക്ഷരതായജ്ഞം	Ernakulam District Total Literarcy Programme; Malayalam Science Books	Ernakulam District Total Literarcy Programme; Malayalam Science Books
narakam1981kssp	നരകം (നാടകം) - ശാസ്ത്രകലാജാഥ - കേരള ശാസ്ത്രസാഹിത്യ പരിഷത്ത്	['Sasthra Kala Jatha, Street Theatre', 'Kerala Archives']	Sasthra Kala Jatha; Street Theatre; Kerala Archives
navamalika1987kssp	നവമാലിക - സംഗീതശില്പം- ശാസ്ത്രസാംസ്കാരികജാഥ 1987 - കേരള ശാസ്ത്രസാഹിത്യ പരിഷത്ത്	Sasthra Kala Jatha, Street Theatre	Sasthra Kala Jatha; Street Theatre

njansthree1990kssp	ഞാൻ സ്ത്രീ - വനിതാകലാജാഥാ സ്ക്രിപ്റ്റുകൾ - കേരള ശാസ്ത്രസാഹിത്യ പരിഷത്ത്	Kala Jatha, Street Theatre	Kala Jatha; Street Theatre
onnaampadam1995kssp	ഒന്നാം പാഠം - വിദ്യാഭ്യാസ ജാഥാ സ്ക്രിപ്റ്റുകൾ - കേരള ശാസ്ത്രസാഹിത്യ പരിഷത്ത്	Kala Jatha, Street Theatre, Kerala Education	Kala Jatha; Street Theatre; Kerala Education
orudheeraswapnam1994kssp	ഒരു ധീര സ്വപ്നം -  ശാസ്ത്രകലാജാഥാ സ്ക്രിപ്റ്റുകൾ - ശാസ്ത്ര സാംസ്കാരിക ജാഥ 1994 - കേരള ശാസ്ത്രസാഹിത്യ പരിഷത്ത്	Sasthra Kala Jatha, Street Theatre	Sasthra Kala Jatha; Street Theatre
orukunjujanikkunnu0000kssp	ഒരു കുഞ്ഞ് ജനിക്കുന്നു - ഗ്രാമശാസ്ത്രജാഥ - കേരള ശാസ്ത്രസാഹിത്യ പരിഷത്ത്	Reproduction, Sex Education	Reproduction; Sex Education
orumaramoruvaram1987kssp	ഒരു മരം ഒരു വരം - പാവനാടകങ്ങൾ - ബാലോത്സവജാഥ 1987 - കേരള ശാസ്ത്രസാഹിത്യ പരിഷത്ത്	Balalsava Jatha, Street Theatre	Balalsava Jatha; Street Theatre
othukali1984kssp	ഒത്തുകളി - ദേശീയ കലാരൂപങ്ങൾ - കേരള ശാസ്ത്രസാഹിത്യ പരിഷത്ത്	Kala Jatha, Street Theatre	Kala Jatha; Street Theatre
ottanthullalukal1980kssp	ഓട്ടൻതുള്ളലുകൾ - ശാസ്ത്രകലാജാഥ - കേരള ശാസ്ത്രസാഹിത്യ പരിഷത്ത്	['Sasthra Kala Jatha, Street Theatre', 'Kerala Archives']	Sasthra Kala Jatha; Street Theatre; Kerala Archives
padanolsavam1998kssp	പഠനോത്സവം - ക്ലാസെടുക്കുന്നവർക്കുള്ള കുറിപ്പുകൾ - കേരള ശാസ്ത്രസാഹിത്യ പരിഷത്ത്	Development	Development
panayapeduthiyabhavi1992kssp	പണയപ്പെടുത്തിയ ഭാവി വീണ്ടെടുക്കാൻ - കേരള സ്വാശ്രയ സമിതി	['Kerala Swasraya Samithi, Economic Policy', 'Kerala Swashraya Samithy']	Kerala Swasraya Samithi; Economic Policy; Kerala Swashraya Samithy
papi1981kssp	പാപി (വിൽപാട്ട്) - ശാസ്ത്രകലാജാഥ - കേരള ശാസ്ത്രസാഹിത്യ പരിഷത്ത്	['Sasthra Kala Jatha, Street Theatre', 'Kerala Archives']	Sasthra Kala Jatha; Street Theatre; Kerala Archives
parishathaduppu0000kssp	പരിഷത്തടുപ്പ് - പ്രവർത്തകരുടെ കൈപ്പുസ്തകം	KSSP leaflets;Parishathaduppu	KSSP leaflets; Parishathaduppu
parishathenthucheyyunnu0000kssp	പരിഷത്ത് എന്തു ചെയ്യുന്നു? - കേരള ശാസ്ത്രസാഹിത്യ പരിഷത്ത്	["People's science movement", 'Kerala Archives']	People's science movement; Kerala Archives
parisheelanarekha1981kssp	1981 - പ്രവർത്തക പരിശീലന രേഖ - കേരള ശാസ്ത്രസാഹിത്യ പരിഷത്ത്	["People's science movement", 'Kerala Archives']	People's science movement; Kerala Archives
parisheelanarekha1982kssp	1982 - പ്രവർത്തക പരിശീലന രേഖ - കേരള ശാസ്ത്രസാഹിത്യ പരിഷത്ത്	["KSSP Cadre Education, People's Science Movement", 'Kerala Archives']	KSSP Cadre Education; People's Science Movement; Kerala Archives
paristhathaduppu0000kssp	1990 - പരിഷത്തടുപ്പ്	KSSP leaflets;Parishathaduppu	KSSP leaflets; Parishathaduppu
pattukal1980kssp	പാട്ടുകൾ - ശാസ്ത്രകലാജാഥ - കേരള ശാസ്ത്രസാഹിത്യ പരിഷത്ത്	KSSP Songs	KSSP Songs
pavanadakangal1988kssp	പാവനാടകങ്ങൾ  - കേരള ശാസ്ത്രസാഹിത്യ പരിഷത്ത്	Sasthra Kala Jatha, Street Theatre, Puppetry Script	Sasthra Kala Jatha; Street Theatre; Puppetry Script
penakalkadha1990kssp	പേനകൾ കഥ പറയുന്നു - സംഗീത ശിൽപങ്ങളും നാടകങ്ങളും - ഭാരത വിജ്ഞാൻ സമിതി	['Bharat Gyanvigyan Samithi Kerala, Street Theatre in Kerala, Literacy, Gender', 'Kerala Sasthra Sahithya Parishad', 'Kerala Archives']	Bharat Gyanvigyan Samithi Kerala; Street Theatre in Kerala; Literacy; Gender; Kerala Sasthra Sahithya Parishad; Kerala Archives
petamma1995kssp	പെറ്റമ്മ - വിദ്യാഭ്യാസ ജാഥാ സ്ക്രിപ്റ്റുകൾ - കേരള ശാസ്ത്രസാഹിത്യ പരിഷത്ത്	Kala Jatha, Street Theatre	Kala Jatha; Street Theatre
pkdjillavikasana1981kssp	1981 - പാലക്കാട് ജില്ല വികസന രേഖ	['Development Palakkad', 'Kerala Development']	Development Palakkad; Kerala Development
prathirodham0000kssp	പ്രതിരോധ കുത്തിവെപ്പുകൾ - ഗ്രാമശാസ്ത്രജാഥ - കേരള ശാസ്ത്രസാഹിത്യ പരിഷത്ത്	vaccination	vaccination
punyabhumiyudethengal1992kssp	പുണ്യഭൂമിയുടെ തേങ്ങൽ - ഗാനങ്ങൾ, സംഗീത ശില്പങ്ങൾ - കേരള ശാസ്ത്രസാഹിത്യ പരിഷത്ത്	Kala Jatha, Street Theatre	Kala Jatha; Street Theatre
puthanpattukar1987kssp	പുത്തൻ പാട്ടുകാർ - ശാസ്ത്രസാംസ്കാരികജാഥ 1987 - കേരള ശാസ്ത്രസാഹിത്യ പരിഷത്ത്	Sasthra Kala Jatha, Street Theatre	Sasthra Kala Jatha; Street Theatre
puthiyapadypadhathi1999kssp	പുതിയ പാഠ്യപദ്ധതി - വിമർശനങ്ങളും വസ്തുതകളും - കേരള ശാസ്ത്രസാഹിത്യ പരിഷത്ത്	Education	Education
saksharathayanjamrandam1991kssp	അക്ഷരകേരളം - സാക്ഷരതായജ്ഞം രണ്ടാം ഘട്ടം - ഇൻസ്ട്രക്റ്റർമാർക്കുള്ള കുറിപ്പുകൾ - കേരള ശാസ്ത്രസാഹിത്യ പരിഷത്ത്	Education, Literacy	Education; Literacy
samathalam1981kssp	സമതലം (നാടകം) - ശാസ്ത്രകലാജാഥ - കേരള ശാസ്ത്രസാഹിത്യ പരിഷത്ത്	['Sasthra Kala Jatha, Street Theatre', 'Kerala Archives']	Sasthra Kala Jatha; Street Theatre; Kerala Archives
samathavinjanotsavam1997kssp	സമത വിജ്ഞാനോത്സവം - പരിശീലകർക്കുള്ള കൈപുസ്തകം - ഭാരത വിജ്ഞാൻ സമിതി	['Bharat Gyanvigyan Samithi Kerala, Samatha Vijnanolsavam, Gender', 'Kerala Sasthra Sahithya Parishad', 'Kerala Archives']	Bharat Gyanvigyan Samithi Kerala; Samatha Vijnanolsavam; Gender; Kerala Sasthra Sahithya Parishad; Kerala Archives
samoohyamanushyanum1982kssp	സാമൂഹ്യമനുഷ്യനും പ്രപഞ്ചവും - ശാസ്ത്രപാഠാവലി - കേരള ശാസ്ത്രസാഹിത്യ പരിഷത്ത്	Science Education	Science Education
sampathikaparishkaram1991kssp	പുതിയ സാമ്പത്തിക പരിഷ്കാരങ്ങളും പ്രത്യാഘാതങ്ങളും - കേരള ശാസ്ത്രസാഹിത്യ പരിഷത്ത്	['Globalization, New Economic Policy', 'Kerala Archives']	Globalization; New Economic Policy; Kerala Archives
samrajyatham1992kssp	സാമ്രാജ്യത്വം ഇന്നലെ, ഇന്ന് – കേരള സ്വാശ്രയ സമിതി	['Imperialism, Globalization', 'Kerala Swashraya Samithy']	Imperialism; Globalization; Kerala Swashraya Samithy
santhigeetham1987kssp	ശാന്തിഗീതം - ഗാനങ്ങൾ  - ശാസ്ത്ര സാംസ്കാരിക ജാഥ 1987 - കേരള ശാസ്ത്രസാഹിത്യ പരിഷത്ത്	Kala Jatha, Street Theatre	Kala Jatha; Street Theatre
sasthragathifeb1968kssp	ശാസ്ത്രഗതി - ലക്കം 4 - 1968 ഫെബ്രുവരി	Sasthragathi	Sasthragathi
sasthragathijan1967kssp	ശാസ്ത്രഗതി ലക്കം 2 - 1967 ജനുവരി- കേരള ശാസ്ത്രസാഹിത്യപരിഷത്ത്	Sasthragathi	Sasthragathi
sasthragathijuly1967kssp	ശാസ്ത്രഗതി - ലക്കം 3 - 1967 ജൂലൈ - കേരള ശാസ്ത്രസാഹിത്യപരിഷത്ത്	['Malayalam Science Magazine', 'Sasthragathi']	Malayalam Science Magazine; Sasthragathi
sasthrageethika1984kssp	ശാസ്ത്രഗീതിക - കേരള ശാസ്ത്രസാഹിത്യ പരിഷത്ത്	Kala Jatha, Street Theatre	Kala Jatha; Street Theatre
sasthragitha0000kssp	ശാസ്ത്രഗീത - ഗ്രാമശാസ്ത്രജാഥ - കേരള ശാസ്ത്രസാഹിത്യ പരിഷത്ത്	Grama Sasthra Jatha	Grama Sasthra Jatha
sasthrakeralam0000kssp	ശാസ്ത്രകേരളം - സയൻസു മാസിക - ലക്കം 1 - 1969 ജൂൺ	Sasthra Keralam Magazine, Malayalam Science Magazine	Sasthra Keralam Magazine; Malayalam Science Magazine
sasthrakeralammay1974kssp	ശാസ്ത്രകേരളം - സയൻസു മാസിക - 1974 മെയ്	Sasthra Keralam Magazine	Sasthra Keralam Magazine
sasthramgramangalkku1982kssp	1982 - ഗ്രാമ ശാസ്ത്രജാഥ - ശാസ്ത്രം ഗ്രാമങ്ങൾക്ക് - കേരള ശാസ്ത്രസാഹിത്യ പരിഷത്ത്	Grama Sasthra Jatha	Grama Sasthra Jatha
sasthramgrameenarkku1983kssp	1983 - ഗ്രാമ ശാസ്ത്രജാഥ - ശാസ്ത്രം ഗ്രാമീണർക്ക് - കേരള ശാസ്ത്രസാഹിത്യ പരിഷത്ത്	Grama Sasthra Jatha	Grama Sasthra Jatha
sasthraparimathru2001kssp	2001 - ശാസ്ത്രസാഹിത്യപരിഷത്ത് പിറക്കുന്നു - ഡോ. കെ.ജി. അടിയോടി	K.G. Adiyodi	K.G. Adiyodi
sasthrapariulgha1962kssp	1962 - ശാസ്ത്രസാഹിത്യപരിഷത്ത് - ഉൽഘാടനസ്മാരകം	['KSSP Souvenir', 'KSSP General Documents']	KSSP Souvenir; KSSP General Documents
sasthrasankethika1993kssp	ഇന്ത്യയുടെ ശാസ്ത്രസാങ്കേതിക രംഗം നേരിടുന്ന പുത്തൻ വെല്ലുവിളികൾ – കേരള സ്വാശ്രയ സമിതി	['Science and Technology Policy', 'Kerala Swashraya Samithy']	Science and Technology Policy; Kerala Swashraya Samithy
seetha1985kssp	സീത - ഗാനങ്ങളും നാടകങ്ങളും സംഗീതശില്പങ്ങളും - ശാസ്ത്രകലാജാഥ 1985 - കേരള ശാസ്ത്രസാഹിത്യ പരിഷത്ത്	Sasthra Kala Jatha, Street Theatre	Sasthra Kala Jatha; Street Theatre
sevanamekhala1993kssp	സേവന മേഖലക്കുമേൽ സാമ്രാജ്യത്വ നീരാളിപ്പിടുത്തം - കേരള സ്വാശ്രയ സമിതി	['Kerala Swasraya Samithi, Globalization, Indian Economy', 'Kerala Swashraya Samithy']	Kerala Swasraya Samithi; Globalization; Indian Economy; Kerala Swashraya Samithy
silentvalleychar0000kssp	സൈലന്റ്‌വാലി ചർച്ച	KSSP leaflets; Silent Valley; KSSP Ecology Books	KSSP leaflets; Silent Valley; KSSP Ecology Books
silentvalleyjala0000kssp	സൈലന്റ്‌വാലി ജലവൈദ്യുതപദ്ധതി - കേരള സ്റ്റേറ്റ് ഇലക്ട്രിസിറ്റി ബോർഡ്	KSSP leaflets;Silent Valley	KSSP leaflets; Silent Valley
silentvalleypari0000kssp	1980 - സൈലന്റ്‌വാലി പദ്ധതി - പരിഷത്തിന്റെ നിലപാടും വിശദീകരണവും	KSSP leaflets;Silent Valley	KSSP leaflets; Silent Valley
sisuvidyabhyasam1999kssp	ശിശുവിഭ്യാഭ്യാസം - കേരള ശാസ്ത്രസാഹിത്യ പരിഷത്ത്	Education	Education
soapinterast2001kssp	2001 - സോപ്പിന്റെ ശാസ്ത്രവും രാഷ്ട്രീയവും	Science Education, Soap, Indian Soap Industry	Science Education; Soap; Indian Soap Industry

souraaduppu0000pgpa	1981 - സൗര അടുപ്പ് - പി.ജി. പത്മനാഭൻ	KSSP leaflets, KSSP energy Books	KSSP leaflets; KSSP energy Books
spartacs1981kssp	സ്‌പാർട്ടക്കസ് (കഥാപ്രസംഗം) - ശാസ്ത്രകലാജാഥ - കേരള ശാസ്ത്രസാഹിത്യ പരിഷത്ത്	['Sasthra Kala Jatha,', 'Kerala Archives']	Sasthra Kala Jatha; ; Kerala Archives
stateconventiono0000kssp	State Convention of Modern Medical Doctors - Draft Manifesto for Discussion	KSSP leaflets;KSSP Health Books;Modern Medical Doctors	KSSP leaflets; KSSP Health Books; Modern Medical Doctors
sthreekalumpinth0000sama	സ്ത്രീകളും പിന്തുടർച്ചാവകാശവും - സമതാവേദി	KSSP leaflets; Samatha leaflets, Gender Bias in Kerala	KSSP leaflets; Samatha leaflets; Gender Bias in Kerala
sthreekalumsaksh0000kssp	സ്ത്രീകളും സാക്ഷരതയും (ചർച്ചയ്ക്കുള്ള കുറിപ്പ്)	KSSP leaflets;KSSP Gender Books;Gender Bias in Kerala	KSSP leaflets; KSSP Gender Books; Gender Bias in Kerala
suryanteathmakadha1979kssp	സൂര്യന്റെ ആത്മകഥ - വി.കെ. ദാമോദരൻ - കേരള ശാസ്ത്രസാഹിത്യ പരിഷത്ത്	Sun, Energy	Sun; Energy
susthiravikasanamjankeeya2018kssp	സുസ്ഥിര വികസനം സുരക്ഷിത കേരളം - ജനകീയ ക്യാമ്പയിൻ - കേരള ശാസ്ത്രസാഹിത്യ പരിഷത്ത്	Development, Flood 2018, Climate Change	Development; Flood 2018; Climate Change
swasryakalajatha0000kssp	സ്വാശ്രയ കലാ ജാഥ - നാടകങ്ങൾ, ഗാനങ്ങൾ, സംഗീതശിൽപങ്ങൾ - കേരള സ്വാശ്രയ സമിതി - കേരള ശാസ്ത്രസാഹിത്യ പരിഷത്ത്	Kala Jatha, Street Theatre	Kala Jatha; Street Theatre
thengumvazhayum0000kssp	തെങ്ങും വാഴയും - ഗ്രാമശാസ്ത്രജാഥ - കേരള ശാസ്ത്രസാഹിത്യ പരിഷത്ത്	Agriculture, Banana, Coconut	Agriculture; Banana; Coconut
thiricharivu1989kssp	തിരിച്ചറിവ് - വനിതാകലാജാഥാ സ്ക്രിപ്റ്റുകൾ - കേരള ശാസ്ത്രസാഹിത്യ പരിഷത്ത്	Kala Jatha, Street Theatre	Kala Jatha; Street Theatre
thudarsaksharatha1992kssp	തുടർസാക്ഷരത - എന്തിന്? എന്ത്? എങ്ങനെ? - പ്രവർത്തകർക്കുള്ള കൈപുസ്തകം	['Kerala Literacy, Education', 'Kerala Literarcy']	Kerala Literacy; Education; Kerala Literarcy
unarthupaatu1989kssp	ഉണർത്തുപാട്ട് - വനിതാകലാജാഥാ സ്ക്രിപ്റ്റുകൾ - കേരള ശാസ്ത്രസാഹിത്യ പരിഷത്ത്	Kalajatha, Street Drama	Kalajatha; Street Drama
unnathavidyabhyasa1999kssp	1999 - ഉന്നത വിദ്യാഭ്യാസരംഗത്തെ പ്രശ്നങ്ങൾ - കേരള ശാസ്ത്രസാഹിത്യ പരിഷത്ത്	['Higher Education Kerala', 'Kerala Education']	Higher Education Kerala; Kerala Education
urjamchodyothara0000kssp	ഊർജം - ചോദ്യോത്തരങ്ങൾ	KSSP leaflets;Kerala Energy	KSSP leaflets; Kerala Energy
vanagatha0000kssp	വനഗാഥ - കേരള ശാസ്ത്രസാഹിത്യ പരിഷത്ത്	Kala Jatha, Street Theatre, Kerala Environment	Kala Jatha; Street Theatre; Kerala Environment
vanaparvam1981kssp	വനപർവം (കക്കാരിശി നാടകം) - ശാസ്ത്രകലാജാഥ - കേരള ശാസ്ത്രസാഹിത്യ പരിഷത്ത്	['Sasthra Kala Jadha, Street Theatre', 'Kerala Archives']	Sasthra Kala Jadha; Street Theatre; Kerala Archives
vanitharekha1987kssp	1987 - പരിഷത്തും സ്ത്രീപ്രശ്നവും - വനിതാരേഖ	Gender	Gender
vayarilakkam0000kssp	വയറുകടിയും വയറിളക്കവും - ഗ്രാമശാസ്ത്രജാഥ - കേരള ശാസ്ത്രസാഹിത്യ പരിഷത്ത്	Health Education, Dysentery	Health Education; Dysentery
vayarilakkamchar0000rajm	വയറിളക്കം ഛർദി അതിസാരം - ഡോ. കെ. രാജ്മോഹൻ	KSSP leaflets;KSSP Health Books	KSSP leaflets; KSSP Health Books
velichamenayi1989kssp	വെളിച്ചമേ നയിച്ചാലും - എറണാകുളം ജില്ല സമ്പൂർണ്ണ സാക്ഷരതായജ്ഞം	['Ernakulam District Total Literarcy Programme', 'Kerala Literacy']	Ernakulam District Total Literarcy Programme; Kerala Literacy
velichamenayicha1989kssp	വെളിച്ചമേ നയിച്ചാലും - എറണാകുളം ജില്ല സമ്പൂർണ്ണ സാക്ഷരതായജ്ഞം	['Ernakulam District Total Literarcy Programme', 'Kerala Literacy']	Ernakulam District Total Literarcy Programme; Kerala Literacy
velichathilekku1989kssp	വെളിച്ചത്തിലേയ്ക്ക് - എറണാകുളം ജില്ല സമ്പൂർണ്ണ സാക്ഷരതായജ്ഞം	['Ernakulam District Total Literarcy Programme', 'Kerala Literacy']	Ernakulam District Total Literarcy Programme; Kerala Literacy
vidyapari2007kssp	2007 - വിദ്യാഭ്യാസ പരിഷ്ക്കാരങ്ങൾ - വിമർശനങ്ങളുടെ നേരും നുണയും	['Education', 'Kerala Education']	Education; Kerala Education
vidyaparvam1995kssp	വിദ്യാപർവ്വം - വിദ്യാഭ്യാസ ജാഥാ സ്ക്രിപ്റ്റുകൾ - കേരള ശാസ്ത്രസാഹിത്യ പരിഷത്ത്	Kala Jatha, Street Theatre	Kala Jatha; Street Theatre
vikasanajatha1998kssp	വികസന ജാഥ - 98	People's Planning; decentralization	People's Planning; decentralization
vikasanamjanangal1989ekmlit	വികസനവും ജനങ്ങളും - അധ്യാപനസഹായി - എറണാകുളം ജില്ല സമ്പൂർണ്ണ സാക്ഷരതായജ്ഞം	['Government welfare schemes in Kerala', 'Ernakulam District Total Literarcy Programme']	Government welfare schemes in Kerala; Ernakulam District Total Literarcy Programme
vikendreekrithaasoothranam0000kssp	വികേന്ദ്രീകൃത ആസൂത്രണം - കേരള ശാസ്ത്രസാഹിത്യ പരിഷത്ത്	['Decentralization, Planning', 'Kerala Archives']	Decentralization; Planning; Kerala Archives
vilapesal1983kssp	വിലപേശൽ - ശാസ്ത്രകലാജാഥാ - കേരള ശാസ്ത്രസാഹിത്യ പരിഷത്ത്	Sasthra Kala Jatha, Street Theatre	Sasthra Kala Jatha; Street Theatre
vilpattukal1980kssp	വിൽപ്പാട്ടുകൾ - ശാസ്ത്രകലാജാഥ - കേരള ശാസ്ത്രസാഹിത്യ പരിഷത്ത്	Sasthra Kala Jatha, Street Theatre	Sasthra Kala Jatha; Street Theatre
vilpattukaltest1980kssp	വിൽപ്പാട്ടുകൾ - ശാസ്ത്രകലാജാഥ - കേരള ശാസ്ത്രസാഹിത്യ പരിഷത്ത്	Kilipattu;  1982	Kilipattu; 1982
vipanikal1994kssp	വിപണികൾ പൂക്കുന്നു -  ശാസ്ത്രകലാജാഥാ സ്ക്രിപ്റ്റുകൾ - ശാസ്ത്ര സാംസ്കാരിക ജാഥ 1994 - കേരള ശാസ്ത്രസാഹിത്യ പരിഷത്ത്	Sasthra Kala Jatha, Street Theatre	Sasthra Kala Jatha; Street Theatre
visittosilentval0000mssw	1979 - Report on the visit to the Silent Valley area of Kerala - M S Swaminathan	KSSP leaflets;Silent Valley	KSSP leaflets; Silent Valley
vithuvaypa1993kssp	വിത്ത് മുതൽ വായ്പ വരെ – കേരള സ്വാശ്രയ സമിതി	['Kerala Swasraya Samithi, Indian Agriculture, Globalization', 'Kerala Swashraya Samithy']	Kerala Swasraya Samithi; Indian Agriculture; Globalization; Kerala Swashraya Samithy
vyavasayameghala1992kssp	പുത്തൻ സാമ്പത്തിക പരിഷ്കാരങ്ങളും വ്യവസായ മേഖലയും - കേരള സ്വാശ്രയ സമിതി	['Globalization, Indian Industry', 'Kerala Swashraya Samithy']	Globalization; Indian Industry; Kerala Swashraya Samithy
vyavasayamgramam1981kssp	1981 - വ്യവസായം ഗ്രാമങ്ങൾക്ക് - കേരള ശാസ്ത്രസാഹിത്യ പരിഷത്ത്	Village Industry, Rural Development	Village Industry; Rural Development
vyavasayasouvenir1980kssp	1980 - വ്യവസായ സുവനീർ - കേരള ശാസ്ത്ര സാഹിത്യ പരിഷത്ത് 17-ാം വാർഷികം	KSSP Souvenir	KSSP Souvenir
vyavasayavalkaranam1986kssp	വ്യവസായവല്ക്കരണം (ചോദ്യോത്തരങ്ങൾ)	Industrialisation of Kerala	Industrialisation of Kerala
yudham1981kssp	യുദ്ധം (നാടകം) - ശാസ്ത്രകലാജാഥ - കേരള ശാസ്ത്രസാഹിത്യ പരിഷത്ത്	['Sasthra Kala Jatha, Street Theatre', 'Kerala Archives']	Sasthra Kala Jatha; Street Theatre; Kerala Archives
